1___1_11_11__1111111
_______11_111_1_1___
1_1_1_1_11_1__1___1_
1_1_11111_____11_11_
11_1__1__11_11_11__1
_111_1____1___1____1
_1111_1__1_111_1111_
_11__11_1_111__11111
_111111__1__1__1___1
___11_1_____111111__
_11111_11___11___111
1_11_111______1____1
1_1_1_11___1___1_11_
1_111__11_11_11___1_
111__111_1_1_1__1___
1__1_1__1_1_1_111_11
_11__11_1_111111__11
_1_1___1____1_11_1__
_111_11___111__1_111
11_1_11___11_111__1_