11111111____11111111
1_____1______1_____1
1_____1______1_____1
1__________________1
1__________________1
1111111__11__1111111
1________11________1
1________11________1
1________11________1
1________11________1
1________11________1
1________11________1
1________11________1
1________11________1
1111111__11__1111111
1__________________1
1__________________1
1__________________1
1__________________1
11111111____11111111