11111111111111111111
11111111111111111111
___111________111___
____________________
____________________
____________________
____________________
____________________
____________________
__11111______11111__
____________________
____________________
____________________
____________________
____________________
____________________
____________________
111111________111111
11111111111111111111
11111111111111111111