11111111111111111111
11111111111111111111
11111111111111111111
1111111______1111111
11111__________11111
1111____________1111
111______________111
111______________111
11________________11
11_________________1
1__________________1
1__________________1
1__________________1
1_______111________1
11_____11111_______1
111____111111_____11
1111__11111111___111
11111111111111111111
11111111111111111111
11111111111111111111