1_____11111111111111
1___________________
1___________________
1___________________
1___________________
111_________________
111______11_________
111______111________
111______1111_______
111______11111______
111______11111______
111_________________
111_________________
111_________________
111_________________
111_________________
1111________________
111111111111111_____
111111111111111_____
11111111111111111111
