1_____11111111111111
____________________
____________________
____________________
____________________
_111____111_________
_111____1111________
_111____11111_______
_111____111111______
_111____111111______
_111____111111______
_111________________
_111________________
_111________________
_111________________
_1111_______________
_11111111111111_____
_11111111111111_____
_11111111111111_____
____________________