111111111__111111111
1__________________1
1__________________1
1__________________1
1__________________1
1__________________1
1__________________1
1__________________1
111______11______111
1111____1__1____1111
1111____1__1____1111
111______11______111
1__________________1
1__________________1
1__________________1
1__________________1
1__________________1
1__________________1
1__________________1
111111111__111111111