11111111111111111111
1__________________1
1__________________1
1__________________1
1__________________1
1__________________1
1__________________1
1111____1__1____1111
1__1____1__1____1__1
1______1____1______1
1______1____1______1
1__1____1__1____1__1
1111____1__1____1111
1__________________1
1__________________1
1__________________1
1__________________1
1__________________1
1__________________1
11111111111111111111